11111111111111111
100010C100000C001
100011110000000P1
10C0000000E000001
11111111111111111