11111111111111111
100010E100000C001
100011110000000P1
10C00000000000001
11111111111111111