1111111111111111111111111111111111111
1000001000000000000000000000000C00001
10000011110000000000000000000000000P1
1000C000000000000000000E0000000000001
1111111111111111111111111111111111111