11111111111111110
1000100000000C001
100011110000000P1
10C0000000E000001
11111111111111111