11111111111111111
10001000000000001
100011110000000P1
1000000000E000001
11111111111111111