11111111111111111
1000100000000C001
100011110000000P1
10C00000000000001
11111111111111111