11111111111111111
1000100000000C001
10001111000000001
10C0000000E000001
11111111111111111