11111111111111111
1000100000000C001
0011110000000P1
10C0000000E000001
11111111111111111