11111111111111111
10001000Z0000C001
100011110000000P1
10C0000000E000001
11111111111111111